###############
#.............#
#........F....#
#.........F...#
#...........F.#
#.............#
#..P..........#
#.P..P........#
#.............#
###############
