###############
#.............#
#.............#
#.............#
#.............#
#.............#
#.............#
#.S...........#
#.............#
###############
